10 10 15
%%%%%%%%%%
%  T .  .%
%  .     %
%  . % ..%
%   .. G%%
%  .     %
%   %%.  %
%...  %. %
%    %.  %
%%%%%%%%%%
 1 3 0
 7 2
 3 7
 7 1
 6 6
 7 7
 8 6
 4 4
 2 3
 3 8
 3 3
 7 3
 4 5
 1 8
 5 3
 1 5
