10 10 15
%%%%%%%%%%
%.% %. ..%
%   .G   %
% T    ..%
%  %     %
% .  %   %
%%... .. %
%.    .  %
%%  %    %
%%%%%%%%%%
 3 2 0
 6 4
 7 6
 6 3
 6 2
 3 7
 7 1
 2 4
 6 7
 1 1
 6 6
 1 7
 5 2
 3 8
 1 8
 1 5
