10 10 15
%%%%%%%%%%
% %      %
%..     %%
%   .  . %
%  . % . %
%     .  %
% .   T. %
% G. ...%%
%  .  .  %
%%%%%%%%%%
 6 6 0
 7 7
 3 4
 8 3
 6 2
 6 7
 7 5
 2 1
 5 6
 8 6
 4 3
 7 3
 7 6
 2 2
 4 7
 3 7
